######
#    #    
#    ######
# $    @ .#
###########
; 0