           ######
######     #    #
#    #######    #
#       $  @   .#
#################
; 1