#################
#        #      #
#  ##### #      #
#      #@#      #
#       $      .#
#      # #      #
#################
; 6