           ######
######     #    #
#    #######    #
#       $    @ .#
############    #
           #    #
           #    #
           ######
; 1