#################
#         #
#         #
#@$   #  .#
#   ####  #
#         #
#################
; 4