#################
#               #
# @$           .#
# $         #  .#
#         ####  #
#               #
#               #
#################
; 7