           ######
######     #    #
#    #######    #
#   @   $      .#
#################
; 1